99999999999999999999999999999999
90000000000000000000000000000009
90000000000000080000000000000009
90000000000000000000000000000009
90000000000000000000000000000009
90000000000000000000000000000009
90007222222222222222222222270009
90007111111111111111111111170009
90000000000000000000000000000009
90000000000000000000000000000009
90000000000000000000000000000009
90000000000000000000000000000009
90000000000000000000000000000009
90000000000000000000000000000009
90000000000000000000000000000009
90000000000000000000000000000009
90000000000000000000000000000009
90000000000000000000000000000009
90000000000000000000000000000009
90000000000000000000000000000009
90000000000000000000000000000009
90000000000000000000000000000009
90000000000000000000000000000009
90000000000000000000000000000009
90000000000000000000000000000009
90000000000000000000000000000009
90000000000000000000000000000009
90000000000000000000000000000009
90000000000000000000000000000009
90000000000000000000000000000009
90000000000000000000000000000009
90000000000000000000000000000009
90000000000000000000000000000009
90000000000000000000000000000009
90000000000000000000000000000009
90000000000000000000000000000009
90000000000000000000000000000009
90000000000000000000000000000009




