99999999999999999999999999999999
90000000000000000000000000000009
90000000000000000000000000000009
92222222222225555522222222222229
90000000000000000000000000000009
90003330000000777000000004440009
90004440000000777000000003330009
90000000000000000000000000000009
92222222222225555522222222222229
90000000000000000000000000000009
90000000000000000000000000000009
90000000000000000000000000000009
90000000000000000000000000000009
90000000000000000000000000000009
90000000000000000000000000000009
90000000000000000000000000000009
90000000000000000000000000000009
90000000000000000000000000000009
90000000000000000000000000000009
90000000000000000000000000000009
90000000000000000000000000000009
90000000000000000000000000000009
90000000000000000000000000000009
90000000000000000000000000000009
90000000000000000000000000000009
90000000000000000000000000000009
90000000000000000000000000000009
90000000000000000000000000000009
90000000000000000000000000000009
90000000000000000000000000000009
90000000000000000000000000000009
90000000000000000000000000000009
90000000000000000000000000000009
90000000000000000000000000000009
90000000000000000000000000000009
90000000000000000000000000000009
90000000000000000000000000000009
90000000000000000000000000000009




